#+TITLE: 在其他linux系统中使用pacman
#+AUTHOR: lujun9972
#+TAGS: linux和它的小伙伴,archlinux
#+DATE: [2018-03-09 五 22:36]
#+LANGUAGE:  zh-CN
#+OPTIONS:  H:6 num:nil toc:t \n:nil ::t |:t ^:nil -:nil f:t *:t <:nil

=pacapt= 是一个很有趣的脚本，它可以把其他系统的包管理软件包装成 =pacman= 来使用。

目前它支持的包管理软件有：

+ dpkg
+ apt-get
+ homebrew
+ macports
+ yum
+ rpm
+ portage
+ zypper
+ pkgng
+ cave
+ pkg_tools
+ sun_tools
+ apk
+ tazpkg
+ swupd

通过下面三个命令就可以安装 pacapt 并将之包装成 pacman

#+BEGIN_SRC shell
  sudo wget -O /usr/bin/pacapt https://github.com/icy/pacapt/raw/ng/pacapt
  sudo chmod 755 /usr/bin/pacapt
  sudo ln -sv /usr/bin/pacapt /usr/bin/pacman
#+END_SRC

pacapt 的语法跟 pacman 十分接近，比如搜索软件可以使用
#+BEGIN_SRC shell :dir /ssh:lujun9972@orangepipc2: :results org
  pacapt -Ss emacs
#+END_SRC

#+RESULTS:
#+BEGIN_SRC org
anthy - input method for Japanese - backend, dictionary and utility
anthy-common - input method for Japanese - common files and dictionary
auctex - integrated document editing environment for TeX etc.
bbdb - The Insidious Big Brother Database (email rolodex) for Emacs
devhelp - GNOME developers help program
dictionaries-common - spelling dictionaries - common utilities
emacs - GNU Emacs editor (metapackage)
emacs-goodies-el - Miscellaneous add-ons for Emacs
emacs24 - GNU Emacs editor (with GTK+ GUI support)
emacs24-bin-common - GNU Emacs editor's shared, architecture dependent files
emacs24-common - GNU Emacs editor's shared, architecture independent infrastructure
emacs24-common-non-dfsg - GNU Emacs common non-DFSG items, including the core documentation
emacs24-dbg - Debugging symbols for emacs24
emacs24-el - GNU Emacs LISP (.el) files
emacs24-lucid-dbg - Debugging symbols for emacs24-lucid
emacs24-nox - GNU Emacs editor (without GUI support)
emacs24-nox-dbg - Debugging symbols for emacs24-nox
emacsen-common - Common facilities for all emacsen
erlang-tools - Erlang/OTP various tools
exuberant-ctags - build tag file indexes of source code definitions
fetchmail - SSL enabled POP3, APOP, IMAP mail gatherer/forwarder
gettext-el - Emacs po-mode for editing gettext .po files
libanthy-dev - input method for Japanese - development files
libanthy0 - input method for Japanese - runtime library
tmux - terminal multiplexer
acl2-emacs - Computational Logic for Applicative Common Lisp: emacs interface
agda - dependently typed functional programming language
agda-bin - commandline interface to Agda
agda-mode - dependently typed functional programming language — emacs mode
agda-stdlib - standard library for Agda
agda-stdlib-doc - standard library for Agda — documentation
alot - Text mode MUA using notmuch mail
alot-doc - Text mode MUA using notmuch mail - documentation
anthy-el - input method for Japanese - elisp frontend
anything-el - open anything / QuickSilver-like candidate-selection framework
apel - portable library for emacsen
aplus-fsf-el - XEmacs lisp for A+ development
ats2-lang - ATS version 2 programming language compiler
auto-complete-el - intelligent auto-completion extension for GNU Emacs
auto-install-el - Auto install elisp file
bbdb3 - Reboot of the BBDB Insidious Big Brother Database for Emacs
bhl - Emacs mode for converting annotated text to HTML and LaTeX
bitmap-mule - bitmap handler for GNU Emacs
c-sig - signature tool for GNU Emacs
cafeobj-mode - Emacs major mode for editing CafeOBJ source code
chktex - Finds typographic errors in LaTeX
cl-iterate - Jonathan Amsterdam's Common Lisp iterator/gatherer/accumulator facility
cl-swank - Superior LISP Interaction Mode for Emacs (Lisp-side server)
clang-format-3.5 - Tool to format C/C++/Obj-C code
clang-format-3.6 - Tool to format C/C++/Obj-C code
clang-format-3.7 - Tool to format C/C++/Obj-C code
clang-format-3.8 - Tool to format C/C++/Obj-C code
cmuscheme48-el - Emacs mode specialized for Scheme48
colordiff - tool to colorize 'diff' output
commit-patch - utility to commit fine grained patches to source code control repositories
common-lisp-controller - Common Lisp source and compiler manager
coq - proof assistant for higher-order logic (toplevel and compiler)
crypt++el - Emacs-Lisp Code for handling compressed and encrypted files
cvc3-el - Emacs mode for CVC3
cxref-emacs - Generates LaTeX and HTML documentation for C programs
darcsum - pcl-cvs like interface for managing darcs patches
dash-el - Modern list manipulation library for Emacs
ddskk - efficient Japanese input system for emacsen
debian-el - Emacs helpers specific to Debian users
develock-el - additional font-lock keywords for the developers on Emacs
devscripts-el - Emacs wrappers for the commands in devscripts
dh-elpa - Debian helper tools for packaging emacs lisp extensions
dictem - Dict client for emacs
dictionary-el - dictionary client for Emacs
dmtcp - Checkpoint/Restart functionality for Linux processes
dmtcp-dbg - Debug package for dmtcp
docbook2x - Converts DocBook/XML documents into man pages and TeXinfo
doxymacs - elisp package for making doxygen usage easier under Emacs
dpkg-dev-el - Emacs helpers specific to Debian development
e2wm - simple window manager for emacs
eblook - electronic dictionary search command using EB Library
ecasound-el - multitrack-capable audio recorder and effect processor (emacs)
ecb - code browser for Emacs supporting several languages
edb - database program for GNU Emacs
edict-el - Emacs interface to Edict
eflite - Festival-Lite based emacspeak speech server
egg - Tamago Ver. 4 -- EGG Input Method Architecture for Emacsen
el-get - install and manage elisp code for Emacs
eldav - interface to the WebDAV servers for Emacs.
elpa-aggressive-indent - Emacs minor mode that reindents code after every change
elpa-async - simple library for asynchronous processing in Emacs
elpa-circe - client for IRC in Emacs
elpa-company - Modular in-buffer completion framework for Emacs
elpa-editorconfig - coding style indenter for all editors - Emacsen plugin
elpa-epl - Emacs Package Library
elpa-expand-region - Increase selected region in Emacs by semantic units
elpa-f - modern API for working with files and directories in Emacs Lisp
elpa-flx - sorting algorithm for fuzzy matching in Emacs
elpa-flx-ido - allows Emacs Ido to use the flx sorting algorithm
elpa-geiser - enhanced Scheme interaction mode for Emacs
elpa-git-commit - Major mode for edditing git commit message
elpa-helm - Emacs incremental completion and selection narrowing framework
elpa-helm-core - Emacs Helm library files
elpa-js2-mode - Emacs mode for editing Javascript programs
elpa-magit - Emacs interface for Git
elpa-magit-popup - Use popup like Magit
elpa-markdown-mode - mode for editing Markdown-formatted text files in GNU Emacs.
elpa-noflet - Emacs Lisp noflet macro for dynamic, local advice
elpa-persp-projectile - integrate perspective.el with projectile
elpa-perspective - tagged workspaces in Emacs
elpa-pkg-info - provide information about Emacs packages
elpa-popup - visual popup user interface library for Emacs
elpa-projectile - project interaction library for Emacs
elpa-rust-mode - Major Emacs mode for editing Rust source code
elpa-sml-mode - Emacs major mode for editing Standard ML programs
elpa-vala-mode - Emacs editor major mode for vala source code
elpa-with-editor - Call program using Emacs as $EDITOR
elscreen - Screen for Emacsen
elserv - HTTP server that runs on Emacsen
emacs-calfw - calendar framework for Emacs
emacs-calfw-howm - calendar framework for Emacs (howm add-on)
emacs-intl-fonts - fonts to allow multilingual PostScript printing from Emacs
emacs-jabber - Jabber client for Emacsen
emacs-mozc - Mozc for Emacs
emacs-mozc-bin - Helper module for emacs-mozc
emacs-nox - GNU Emacs editor (metapackage, without X support)
emacs-window-layout - window layout manager for emacs
emacs24-lucid - GNU Emacs editor (with Lucid GUI support)
emacspeak - speech output interface to Emacs
emacspeak-espeak-server - espeak syntesis server for emacspeak
emacspeak-ss - Emacspeak speech servers for several synthesizers
emms - Emacs MultiMedia System
erc - an IRC client for Emacs
erlang - Concurrent, real-time, distributed functional language
erlang-mode - Erlang major editing mode for Emacs
ess - Emacs mode for statistical programming and data analysis
etktab - ASCII guitar tab editor
evernote-mode - Emacs major mode for editing Evernote directly
eweouz - Emacs interface to Evolution Data Server
flim - library about internet message for emacsen
geiser - Transition Package, geiser to elpa-geiser
ghc-mod - Happy Haskell programming
ghc-mod-el - Happy Haskell programming with Emacs
git-el - fast, scalable, distributed revision control system (emacs support)
global - Source code search and browse tools
gmult - figure out which letters are which numbers
gnat-gps - integrated development environment for C and Ada
gnats - problem report management system - central database
gnats-user - problem report management system - client tools
gnu-smalltalk-el - GNU Smalltalk Emacs front-end
gnuplot-mode - Gnuplot mode for Emacs
gnuserv - Allows you to attach to an already running Emacs
goby - WYSIWYG presentation tool for Emacs
gocode-auto-complete-el - gocode integration for Emacs
golang-mode - Go programming language - mode for GNU Emacs
gramadoir - Irish language grammar checker (integration scripts)
gri-el - Emacs major-mode for gri, a language for scientific graphics
haml-elisp - Emacs Lisp mode for the Haml markup language
haskell-mode - major mode for editing Haskell in Emacs
howm - Note-taking tool on Emacs
icicles - emacs library that enhances minibuffer/input completion
id-utils - Fast, high-capacity, identifier database tool
idl-font-lock-el - OMG IDL font-locking for Emacs
idn - Command line and Emacs interface to GNU Libidn
ilisp - Emacs interface to LISP implementations
ilisp-doc - Documentation for ILISP package
info2man - Convert GNU info files to POD or man pages
inform-mode - Emacs mode for editing Inform files
initz - Handles the switching of various initialization files of emacsen
inotify-hookable - blocking command-line interface to inotify
irony-mode - C/C++ minor mode powered by libclang
ispell - International Ispell (an interactive spelling corrector)
jed - editor for programmers (textmode version)
jedit - Plugin-based editor for programmers
joe - user friendly full screen text editor
jove - Jonathan's Own Version of Emacs - a compact, powerful editor
js2-mode - Emacs mode for editing Javascript programs (dummy package)
jupp - user friendly full screen text editor
kdesdk-scripts - scripts and data files for development
kxterm - CERNLIB data analysis suite - KUIP terminal emulator
latex-cjk-common - LaTeX macro package for CJK (Chinese/Japanese/Korean)
ledger-el - command-line double-entry accounting program (emacs interface)
ledit - line editor for interactive programs
libconfig-find-perl - module to search configuration files using OS dependent heuristics
libghc-agda-dev - dependently typed functional programming language
libghc-agda-doc - dependently typed functional programming language; documentation
libghc-pandoc-dev - general markup converter - libraries
libghc-pandoc-doc - general markup converter - library documentation
libghc-pandoc-prof - general markup converter - profiling libraries
libgnu-regexp-java - Regular Expressions for Java
libjline2-java - console input handling in Java
libkkc-common - Japanese Kana Kanji input library - common data
libkkc-data - language model data for libkkc
libkkc-dev - Japanese Kana Kanji input library - development files
libkkc-utils - Japanese Kana Kanji input library - testing utility
libkkc-utils-dbg - Japanese Kana Kanji input library - utility debugging symbols
libkkc2 - Japanese Kana Kanji input library
libkkc2-dbg - Japanese Kana Kanji input library - library debugging symbols
liblatex-table-perl - Perl extension for the automatic generation of LaTeX tables
libledit-ocaml-dev - OCaml line editor library
libocp-indent-lib-ocaml - OCaml indentation tool for emacs and vim - libraries
libocp-indent-lib-ocaml-dev - OCaml indentation tool for emacs and vim - development libraries
libparse-exuberantctags-perl - exuberant ctags parser for Perl
libpcre-ocaml - OCaml bindings for PCRE (runtime)
libpcre-ocaml-dev - OCaml bindings for PCRE (Perl Compatible Regular Expression)
libproc-invokeeditor-perl - Perl extension for starting a text editor
libre-ocaml-dev - regular expression library for OCaml
librep-dev - development libraries and headers for librep
librep16 - embedded lisp command interpreter library
librobert-hooke-clojure - Function wrapper library for Clojure
libtext-findindent-perl - module to heuristically determine indentation style
libutop-ocaml - improved OCaml toplevel (runtime library)
libutop-ocaml-dev - improved OCaml toplevel (development tools)
liece - IRC (Internet Relay Chat) client for Emacs
liece-dcc - DCC program for liece
liquidsoap-mode - Emacs mode for editing Liquidsoap code
lisaac-mode - Emacs mode for editing Lisaac programs
lookup-el - emacsen interface to electronic dictionaries
lsdb - The Lovely Sister Database (email rolodex) for Emacs
lua-mode - Emacs mode for editing Lua programs
lyskom-elisp-client - emacs client for LysKOM
malaga-mode - System for automatic language analysis - emacs mode
maxima-emacs - Computer algebra system -- emacs interface
mew - mail reader supporting PGP/MIME for Emacs
mew-beta - mail reader supporting PGP/MIME for Emacs (development version)
mg - microscopic GNU Emacs-style editor
mgp - MagicPoint- an X11 based presentation tool
mh-e - Emacs interface to the MH mail system
mhc - schedule management tool for Emacs
mhc-utils - utilities for the MHC schedule management system
midge - A text to MIDI program
migemo-el - Japanese incremental search with Romaji on Emacsen
minlog - Proof assistant based on first order natural deduction calculus
mit-scheme-doc - MIT/GNU Scheme documentation
mksh - MirBSD Korn Shell
mmm-mode - Multiple Major Mode for Emacs
mpg123-el - front-end to mpg321/ogg321 media players for Emacs
mpqc-support - Massively Parallel Quantum Chemistry Program (support tools)
mu-cite - message citation utility for emacsen
mu4e - e-mail client for Emacs based on mu (maildir-utils)
muse-el - Author and publish projects using Wiki-like markup
navi2ch - 2channel Navigator for Emacs
nescc - Programming Language for Deeply Networked Systems
nethack-el - Emacs major-mode for playing NetHack
nethack-lisp - dungeon crawl game - Lisp interface
ng-cjk - Nihongo MicroGnuEmacs with CJK support
ng-cjk-canna - Nihongo MicroGnuEmacs with CJK and Canna support
ng-common - Common files used by ng-* packages
ng-latin - Nihongo MicroGnuEmacs with Latin support
nmh - set of electronic mail handling programs
nomarch - Unpacks .ARC and .ARK MS-DOS archives
notmuch-addrlookup - Address lookup tool for Notmuch
notmuch-emacs - thread-based email index, search and tagging (emacs interface)
ocaml-core - OCaml core tools (metapackage)
ocaml-mode - major mode for editing Objective Caml in Emacs
ocp-indent - OCaml indentation tool for emacs and vim - runtime
oneliner-el - extensions of Emacs standard shell-mode
org-mode - keep notes, maintain ToDo lists, and do project planning in emacs
otags - tags file generator for OCaml
pandoc - general markup converter
pandoc-data - general markup converter - data files
paredit-el - Emacs minor mode for structurally editing Lisp code
php-elisp - Emacs support for php files
planner-el - personal information manager for Emacs
post-el - emacs major mode for editing mail
prolog-el - Emacs major mode for editing Prolog code
proofgeneral - generic frontend for proof assistants
proofgeneral-doc - generic frontend for proof assistants - documentation
psgml - Emacs major mode for editing SGML documents
puppet-el - syntax highlighting for puppet manifests in emacs
pylint - Python code static checker and UML diagram generator
pylint3 - Python 3 code static checker and UML diagram generator
pymacs - interface between Emacs Lisp and Python
pyrex-mode - emacs-lisp pyrex-mode for pyrex
python-editor - programmatically open an editor, capture the result - Python 2.7
python-mode - Python mode for GNU Emacs and XEmacs
python-rope - Python refactoring library
python-ropemacs - Emacs mode for Python refactoring
python-ropemode - ropemode, a helper for using rope refactoring library in IDE
python3-editor - programmatically open an editor, capture the result - Python 3.x
rabbit-mode - Emacs-lisp rabbit-mode for writing RD document using Rabbit
rail - Replace Agent-string Internal Library
ranger - File manager with an ncurses frontend written in Python
rdtool-elisp - Emacs-lisp rd-mode for writing RD document
refdb-clients - Reference database and bibliography tool - clients
refdb-doc - Reference database and bibliography tool - doc
refdb-server - Reference database and bibliography tool - sql server
refdb-www - Reference database and bibliography tool - www server
remembrance-agent - Emacs mode to help find relevant texts
rep - lisp command interpreter
rep-doc - documentation for the lisp command interpreter
riece - IRC client for Emacs
rnc-mode - Emacs editing mode for RELAX NG Compact syntax
ruby-github-markup - GitHub Markup rendering
ruby-org - Emacs org-mode parser for Ruby
s-el - String manipulation library for Emacs
sass-elisp - Emacs Lisp mode for the Sass markup language
sawfish - window manager for X11
scala-mode-el - Emacs major mode for editing scala source code
search-ccsb - BibTeX search tool
search-citeseer - BibTeX search tool
select-xface - utility for selecting X-Face on emacsen
semi - library to provide MIME feature for emacsen
sepia - Simple Emacs-Perl InterAction
silversearcher-ag-el - Emacs frontend to ag
singular-ui-emacs - Computer Algebra System for Polynomial Computations -- emacs user interface
sisu - documents - structuring, publishing in multiple formats and search
slime - Superior LISP Interaction Mode for Emacs
speechd-el - Emacs speech client using Speech Dispatcher
speechd-el-doc-cs - speechd-el documentation in Czech
speechd-up - Interface between Speech Dispatcher and SpeakUp
stow - Organizer for /usr/local software packages
stumpwm - tiling, keyboard driven Common Lisp window manager
supercollider-emacs - SuperCollider mode for Emacs
sylpheed - Light weight e-mail client with GTK+
t-code - Japanese direct input method environment for emacsen
t-code-common - Japanese direct input method environment - common files
tdiary-mode - tDiary editing mode for Emacsen
tiarra-conf-el - edit mode for tiarra.conf
timidity-el - Emacs front end to Timidity++
tkcon - Enhanced interactive console for developing in Tcl
tpp - text presentation program
tuareg-mode - emacs-mode for ocaml programs
tweak - Efficient text-mode hex editor
twittering-mode - Twitter client for Emacs
txt2regex - A Regular Expression "wizard", all written with bash2 builtins
tzc - Trivial Zephyr Client
uim-el - Universal Input Method - Emacs front end
uim-latin - Universal Input Method - Latin script input support
urweb-mode - Emacs mode for editing Ur/Web programs
utop - improved OCaml toplevel
uzbl - Lightweight Webkit browser following the UNIX philosophy
verbiste-el - French and Italian conjugator - emacs extension
vile - VI Like Emacs - vi work-alike
vile-common - VI Like Emacs - support files for vile/xvile
vile-filters - VI Like Emacs - highlighting filters for vile/xvile
vim-voom - Vim two-pane outliner
vm - mail user agent for Emacs
w3m-el - simple Emacs interface of w3m
w3m-el-snapshot - simple Emacs interface of w3m (development version)
whizzytex - a WYSIWYG emacs environment for LaTeX
windows-el - window manager for GNU Emacs
wl - mail/news reader supporting IMAP for emacsen
wl-beta - mail/news reader supporting IMAP for emacsen (development version)
wordwarvi - retro-styled side-scrolling shoot'em up arcade game
wordwarvi-sound - retro-styled side-scrolling shoot'em up arcade game [Sound Files]
wysihtml-el - Almost real-time previewing system for HTML and DocBook
x-face-el - utility for displaying X-Face on emacsen
xcite - exciting cite utility for Emacsen
xcscope-el - Interactively examine a C program source in emacs
xemacs21 - highly customizable text editor
xemacs21-basesupport - Editor and kitchen sink -- compiled elisp support files
xemacs21-basesupport-el - Editor and kitchen sink -- source elisp support files
xemacs21-bin - highly customizable text editor -- support binaries
xemacs21-mule - highly customizable text editor -- Mule binary
xemacs21-mule-canna-wnn - highly customizable text editor -- Mule binary compiled with Canna and Wnn
xemacs21-mulesupport - Editor and kitchen sink -- Mule elisp support files
xemacs21-mulesupport-el - Editor and kitchen sink -- source elisp support files
xemacs21-nomule - highly customizable text editor -- Non-mule binary
xemacs21-support - highly customizable text editor -- architecture independent support files
xemacs21-supportel - highly customizable text editor -- non-required library files
xfonts-bitmap-mule - fonts of BITMAP-MULE for X
xfonts-kapl - APL fonts for A+ development
xfonts-terminus-oblique - Oblique version of the Terminus font
xfonts-thai-etl - Thai etl fonts for X
xfonts-thai-poonlap - Poonlap Veerathanabutr's bitmap fonts for X
xjed - editor for programmers (x11 version)
xstow - Extended replacement of GNU Stow
xul-ext-exteditor - edit Icedove messages in an external editor
xvile - VI Like Emacs - vi work-alike (X11)
yaml-mode - emacs mode for YAML files
yasnippet - Template system for Emacs
yasnippet-snippets - Andrea Crotti's official yasnippet snippets
yasr - General-purpose console screen reader
yatex - Yet Another TeX mode for Emacs
yc-el - Yet another Canna client for Emacsen
yorick - interpreted language and scientific graphics
zeal - Simple offline API documentation browser
zeal-dbg - Debug symbols for zeal
zile - very small Emacs-subset editor
org-mode-doc - keep notes, maintain ToDo lists, and do project planning in emacs
sdic - Emacs interface for Japanese dictionaries
wnn7egg - Wnn-nana-tamago -- EGG Input Method with Wnn7 for Emacsen
x-pgp-sig-el - X-PGP-Sig mail and news header utility for Emacs
clang-format-3.9 - Tool to format C/C++/Obj-C code
clang-format-4.0 - Tool to format C/C++/Obj-C code
clang-format-5.0 - Tool to format C/C++/Obj-C code
#+END_SRC
